296 296 296 296 296 296 296 296 296 296 296 296 296 296 296 296 296 296 296 296 296 296 296 296 296 296 296 296 296 296 296 296 296 296 296 296 296 296 296 296 296 296 296 296 296 296 296 296 296 296 
296 296 296 296 296 296 296 296 296 305 296 296 296 296 296 296 296 296 296 296 296 296 296 296 296 296 296 296 296 296 296 288 289 289 290 296 296 296 296 296 296 296 296 296 296 296 296 296 296 296 
296 296 296 296 296 296 296 296 296 296 296 296 296 296 296 296 296 296 296 296 296 296 296 296 296 296 296 296 296 296 304 291 35 134 292 296 296 296 296 296 296 296 296 296 296 296 296 296 296 296 
296 302 296 303 296 296 296 296 296 296 296 296 296 296 296 300 296 296 296 296 296 296 296 296 296 296 296 296 300 296 296 291 134 134 292 296 296 296 296 302 296 296 296 304 296 296 296 296 296 302 
296 296 296 296 296 296 300 296 296 296 296 296 296 301 296 296 296 296 302 296 303 296 296 296 302 296 296 296 296 296 296 298 293 293 294 303 296 296 296 296 288 289 290 296 296 296 302 296 296 296 
296 296 296 288 289 289 289 289 290 296 302 296 296 296 296 296 296 296 296 296 296 300 296 296 296 296 296 296 296 296 296 296 296 296 296 296 302 296 296 296 298 293 294 296 296 296 296 296 296 296 
300 296 296 291 23 24 25 269 306 289 289 289 289 289 289 289 289 289 289 290 296 296 296 296 296 296 296 301 296 296 296 296 296 296 296 296 296 296 296 296 296 296 296 296 296 300 296 296 296 296 
296 304 288 307 26 27 28 66 262 10 66 17 18 66 66 66 236 66 66 306 289 289 289 289 289 289 290 296 296 296 296 302 296 296 296 296 296 296 296 296 296 296 302 296 296 296 296 296 301 296 
289 289 307 236 29 30 31 66 66 238 239 19 20 11 66 66 66 66 23 24 25 5 66 66 66 66 306 289 289 289 289 290 296 300 296 296 296 301 296 296 296 296 296 296 296 296 296 296 296 296 
467 467 467 467 363 33 34 66 66 66 66 21 22 66 66 66 66 5 26 27 28 66 66 66 287 66 66 66 287 66 66 306 289 289 289 290 296 296 296 296 296 305 296 296 296 296 296 296 296 288 
467 467 363 66 364 5 66 66 270 66 66 5 238 239 235 66 66 66 29 30 31 66 66 66 66 237 239 66 66 66 5 66 235 66 66 306 289 289 289 289 289 290 296 296 296 296 296 296 296 291 
470 366 365 66 364 66 235 66 66 23 24 25 61 62 63 64 65 66 32 33 34 66 66 262 66 66 66 66 66 17 18 66 66 23 24 25 66 66 66 66 66 306 289 289 290 296 296 299 296 291 
364 470 366 366 365 66 66 66 66 26 27 28 56 57 58 59 60 66 66 66 66 66 66 66 23 24 25 66 66 19 20 66 66 26 27 28 66 66 66 235 66 66 287 66 306 290 296 296 296 291 
364 474 363 66 66 66 11 66 66 29 30 31 51 52 53 54 55 66 66 236 11 66 287 66 26 27 28 66 66 21 22 66 66 29 30 31 66 287 66 66 17 18 66 66 66 292 296 296 296 291 
474 363 364 238 239 66 66 66 66 32 33 34 46 47 48 49 50 66 66 66 66 66 66 66 29 30 31 66 66 66 66 66 66 32 33 34 66 66 66 66 19 20 66 66 235 292 296 304 296 291 
66 364 364 66 66 66 66 135 287 66 66 66 41 42 43 44 45 66 66 5 66 66 66 66 32 33 34 66 66 66 11 66 66 66 66 66 66 11 66 66 21 22 66 237 239 292 296 296 296 291 
66 364 474 467 363 5 134 134 134 66 66 66 36 37 38 39 40 66 135 135 66 66 66 279 280 281 282 66 66 66 66 66 269 66 66 66 66 66 66 66 134 134 134 66 66 292 296 296 296 291 
66 474 467 363 364 66 134 134 134 66 66 11 66 240 13 2 66 66 135 135 8 66 478 283 284 286 285 479 66 66 235 66 66 66 66 228 229 136 228 229 136 136 136 287 66 292 296 299 296 291 
134 66 470 365 364 66 66 66 66 66 66 66 66 241 1 2 66 66 135 35 66 66 0 271 272 273 274 2 66 66 66 66 136 100 101 230 231 12 230 231 107 106 136 136 66 292 296 296 296 291 
366 366 365 66 364 66 246 247 248 66 66 238 239 0 1 242 66 66 66 5 66 66 0 275 276 277 278 2 4 66 66 66 98 99 13 233 13 13 13 13 232 105 104 136 319 320 321 322 323 324 
366 366 366 366 365 66 66 66 66 66 246 248 225 0 13 243 66 287 249 250 251 66 476 15 1 1 16 477 225 66 66 8 97 13 13 13 13 232 13 13 13 13 103 478 325 326 327 328 329 330 
12 12 12 12 12 12 12 12 496 497 498 12 12 220 232 219 12 12 255 254 253 12 12 121 1 232 122 12 12 12 12 12 121 13 13 13 310 311 312 13 13 13 122 121 331 332 333 334 335 336 
13 13 13 13 13 13 233 499 500 501 502 13 13 232 13 13 13 13 13 13 13 13 13 13 13 13 13 233 13 13 13 13 13 232 13 13 313 314 315 13 233 13 13 232 337 338 339 340 341 342 
14 14 14 14 14 14 14 503 504 505 506 14 14 14 14 14 14 14 14 14 14 14 14 14 14 14 14 14 14 14 14 14 15 13 13 233 316 317 318 13 13 13 16 14 343 344 345 346 347 348 
467 467 363 66 66 235 238 239 66 66 246 247 247 248 66 66 66 66 66 66 66 66 66 66 66 66 66 66 66 66 66 66 119 13 13 13 13 13 13 232 13 13 113 136 349 292 296 299 296 291 
363 134 474 363 66 66 66 66 66 66 507 508 507 293 508 66 287 66 66 236 66 66 66 66 66 66 17 18 66 66 66 11 118 116 13 13 13 13 13 13 13 111 112 136 136 292 304 296 296 291 
474 467 363 364 135 66 66 17 18 66 292 297 294 296 291 262 66 66 66 66 66 66 66 66 7 7 19 20 66 66 66 66 66 117 115 14 15 1 16 14 109 110 507 293 293 294 296 296 296 291 
134 134 364 364 66 287 66 19 20 235 292 304 296 296 298 508 66 66 66 4 66 66 66 66 66 66 21 22 66 66 246 247 248 66 66 5 259 1 2 66 66 235 292 304 296 296 296 296 296 291 
134 134 364 364 66 66 66 21 507 293 294 296 296 296 296 291 66 23 24 25 66 66 66 66 35 66 66 11 66 66 66 66 235 66 66 66 260 1 2 66 270 66 292 296 299 296 296 296 296 291 
134 134 364 364 4 66 66 66 292 296 296 301 296 304 296 291 66 26 27 28 66 11 66 66 66 66 66 66 235 66 66 66 66 66 66 66 261 233 2 66 66 66 292 296 296 296 296 304 296 291 
134 470 365 364 66 66 66 66 306 289 289 290 296 296 296 291 66 29 30 31 66 66 66 66 66 66 66 66 66 5 66 66 66 66 11 66 0 1 2 66 66 4 509 289 289 290 296 296 296 298 
134 364 134 364 66 244 245 235 246 247 486 292 296 288 289 307 66 32 33 34 66 66 236 66 4 66 287 66 66 66 66 66 262 66 237 239 0 1 2 66 66 135 135 135 135 306 289 289 290 288 
366 365 134 364 66 226 227 263 264 66 491 306 289 307 66 66 66 66 66 66 66 66 66 66 134 134 134 134 134 287 134 134 66 66 66 66 0 1 2 249 250 250 251 135 279 280 281 282 306 307 
134 470 366 365 134 98 106 265 266 61 62 63 64 65 244 245 66 66 66 5 209 210 207 208 205 206 203 204 191 192 134 134 134 235 66 66 0 1 122 252 254 254 253 12 283 284 286 285 479 66 
134 474 363 66 98 121 105 66 66 56 57 58 59 60 66 66 66 66 66 66 217 216 216 215 213 214 211 212 201 202 199 134 134 66 17 18 0 1 1 1 1 1 232 1 271 272 273 274 2 5 
467 363 364 66 118 116 111 244 245 51 52 53 54 55 5 66 66 235 66 66 197 198 196 195 193 184 184 172 170 170 167 66 66 66 19 20 0 1 16 14 14 14 15 1 275 276 277 278 256 66 
134 364 364 23 24 25 97 122 104 46 47 48 49 50 66 66 66 66 287 66 165 166 163 163 193 194 181 182 179 180 167 134 11 134 21 22 0 1 2 225 287 235 0 1 1 1 1 232 258 66 
134 364 364 26 27 28 117 476 479 41 42 43 44 45 66 66 66 66 66 66 165 166 163 163 151 152 147 149 147 148 145 479 134 134 134 134 0 1 122 12 479 66 476 14 14 14 14 14 477 262 
134 364 364 29 30 31 66 118 113 36 37 38 39 40 66 66 66 66 66 66 175 176 173 174 161 162 159 160 157 158 155 2 66 66 4 66 0 1 1 1 2 66 11 66 66 244 245 263 264 66 
470 365 364 32 33 34 66 487 146 495 15 13 256 66 66 66 287 66 66 66 143 144 131 132 129 130 127 126 125 126 123 2 66 66 66 66 476 14 15 1 242 66 66 66 236 66 104 265 266 66 
364 134 474 363 5 66 66 488 489 486 0 233 258 225 66 66 66 237 239 66 66 66 249 250 251 115 14 15 16 14 14 477 225 228 229 66 66 66 0 233 243 66 100 106 263 264 106 5 244 245 
474 467 363 364 134 134 134 134 134 483 0 13 122 12 12 12 12 12 12 12 12 12 252 254 253 12 12 121 122 12 12 12 12 230 231 12 12 12 121 1 105 104 115 110 267 268 66 66 67 68 
134 134 364 364 134 134 134 134 35 487 0 13 13 13 13 232 13 13 13 13 13 13 13 13 13 13 13 13 232 13 13 13 13 13 13 234 13 13 13 1 111 112 66 235 66 66 66 66 69 70 
134 134 364 364 134 134 134 8 134 491 476 14 14 14 14 14 14 14 14 14 14 14 14 14 14 14 14 14 14 14 14 116 13 111 14 14 14 14 15 1 2 244 245 66 66 9 66 235 71 72 
470 366 365 364 135 410 411 448 449 450 448 449 450 448 449 450 448 449 450 448 449 450 448 449 450 448 449 450 448 449 450 448 449 450 429 430 66 350 351 352 353 354 66 410 411 448 449 450 448 449 
364 136 470 365 412 413 414 451 452 453 451 452 453 451 452 453 451 452 453 451 452 453 451 452 453 451 452 453 451 452 453 451 452 453 431 432 433 355 356 357 358 359 412 413 414 451 452 453 451 452 
365 136 364 415 416 417 456 454 455 456 454 455 456 454 455 456 454 455 456 454 455 456 454 455 456 454 455 456 454 455 456 454 455 456 434 435 436 437 351 352 353 415 416 417 418 454 455 456 454 455 
136 136 364 419 420 421 459 457 458 459 457 458 459 457 458 459 457 458 459 457 458 459 457 458 459 457 458 459 457 458 459 457 458 459 438 439 440 441 356 357 358 419 420 421 422 457 458 459 457 458 
136 136 364 136 423 424 462 460 461 462 460 461 462 460 461 462 460 461 462 460 461 462 460 461 462 461 461 462 460 461 462 460 461 462 442 443 444 66 0 1 2 6 423 424 425 460 461 462 460 461 
467 363 474 467 363 134 465 463 464 465 463 464 465 463 464 465 463 464 465 463 464 465 463 464 465 463 464 465 463 464 465 463 464 465 426 427 134 6 0 1 2 66 134 426 427 463 464 465 463 464 
