0 0 0 0 0 0 0 0 0 0 0 0 0 0 0 0 0 0
0 0 0 0 0 0 0 0 0 0 0 0 0 0 0 0 0 0
0 0 0 0 0 0 0 0 0 0 0 0 0 0 0 0 0 0
0 0 0 0 0 0 0 0 0 0 0 0 0 0 0 0 0 0
0 0 0 0 0 0 0 0 0 7 4 0 0 0 0 0 0 0
0 0 0 0 0 0 0 0 7 10 11 4 0 0 0 0 0 0
8 8 8 8 8 8 8 8 10 2 2 11 4 0 0 0 0 0
9 9 9 9 9 9 9 9 12 2 2 13 6 0 0 0 0 0
0 0 0 0 0 0 0 0 5 12 13 6 0 0 0 0 0 0
0 0 0 0 0 0 0 0 0 5 6 0 0 0 0 0 0 0
0 0 0 0 0 0 0 0 0 0 0 0 0 0 0 0 0 0
0 0 0 0 0 0 0 0 0 0 0 0 0 0 0 0 0 0
0 0 0 0 0 0 0 0 0 0 0 0 0 0 0 0 0 0
0 0 0 0 0 0 0 0 0 0 0 0 0 0 0 0 0 0
0 0 0 0 0 0 0 0 0 0 0 0 0 0 0 0 0 0
0 0 0 0 0 0 0 0 0 0 0 0 0 0 0 0 0 0
